NO ./textures/fence/blue.xpm
SO ./textures/fence/brown.xpm
WE ./textures/fence/purple.xpm
EA ./textures/fence/barbie.xpm

C 135,206,235
F 86,125,70

11111111111111111111111111111
10000000001100000000000000001
10010100011100000000000010001
10010100001100000110000010001
11111100011100000110000010001
10000000001100000111011110001
11110011111111011100000010001
11110011111111011111011110001
11000001010101011100000010001
10000000000000001100000010001
10000000000000001101010010001
10000000000000001101010010N01
11000001010101011111011110001
11110011111111111111011110001
11110011111111111111111111011
10010000000000000000000000001
10000001100110011011001100111
11111111111111111111111111111