11111111
10000E01
10000001
10000001
10000001
10000001
10000001
10000001
11111111
11111111
