NO textures/fence/purple.xpm
SO textures/fence/purple.xpm
WE textures/fence/purple.xpm
EA textures/fence/purple.xpm


C 0,191,255
F textures/grass/grass.xpm

      1111111                                        1111111
     100000001                                      1000L0001
     100000L01                                      100000001
  111100111111111111111111111111111111111111111111111111100111
 10L00000000000000000000011111111111100000000000000000000000001
1111111000000000000000000001111111000000000000000000011111111111
1000000000000000000000000000011100000000000000000000000000011111
1000000111101111111111000000000000000000001111111111010000000111
1110000000100000000001110000000000000000001000000000010000000011
11100000L01000000LLLL1111111110000000000001000000LLLL10000000001
1000011111100000LLL00111111100000111111111100000LLL0011111000001
1000011111100000LLL00100000000000011111111100000LLL0011111100001
100000000010000000LLL10000000000000000001110000000LLL10000000001
1111100001111001111111000000000000000000001111111001111000011111
1111000011111100000000000000000000000000000000000011111100000111
100000011000011000000000000011111000000000000000011LLLL110000001
1000000110L0011000000000000000100000000000000000011LL00110000001
1000N001100000000000000000000000000000000000000000000001100L0001
1111111111111111111111111111111111111111111111111111111111111111