NO ./textures/fence/barbie.xpm
SO ./textures/fence/barbie.xpm
WE ./textures/fence/barbie.xpm
EA ./textures/fence/barbie.xpm

C 135,206,235
F 86,125,70

1111111111111111111111111111111111111111111111111111111111111
1000000000000000000000000000000000000000000000000000100000001
1000111111111111111111000000000000000000000000000000100000001
1000100000000000000001000000000000000000000000000000000111111
1000100000000000000001000000000011111111111111100000000000001
1000100111111111111001000000001110000010000010111000000000001
1000100100000000000001000000111000010010000010001110000000001
1000100100000000000001000011100000010010010010000011100000001
1000100100111111111111000111000000010010010010000001110000001
1000000000000000000000000011100000010010010010000011100000001
1000000111111111111111000000101000010010010000001010000000001
1000000111111111111111000000001110010000010000111000000000001
1000000000000000000000000000000011110000010111100000000000001
1000000001110000011100000000000000011111111100000000000000001
1000000110001101100011000000000000000011110000000001111111111
1000001100000000000001100000000000000011110000000000000000001
1000011000111111111111110000000000000011110000000000000000001
1000001100000000000001100000000000000011110000000000000000001
1000000111111111100011000000000000000011110000000001111111111
1000000011000000000110000000000000000011110000000000000000001
1000000001100011111100000000000001111111111111100000000000001
1000000000110000011000000000000000000011110000000001111111111
1111110000011000110000000000000000000011110000000000000000001
1000000010001101100000000000000000000011110000000100000000001
1000000010000000000000000000000000000000000000001100000000001
10000000100000N0000000000000000000000000000000001100000000001
1111111111111111111111111111111111111111111111111111111111111
