NO ./textures/fence/barbie.xpm
SO ./textures/fence/barbie.xpm
WE ./textures/fence/barbie.xpm
EA ./textures/fence/barbie.xpm

F ./textures/grass/grass.xpm
C 135,206,235

1111111111111111111111111111111111111111111111111111111111111
1000000000000000000000000000000000000000000000000000100000001
10001111111111111111110000000000000000000000000000001000000L1
1000100000000000000001000000000000000000000000000000000111111
1000100000000L00000001000000000011111111111111100000000000001
100010011111111111100100000000111000001000001L111000000000001
1000100100000000000001000000111000010010000010001110000000001
1000100100000000000001000011100000010010010010000011100000001
1000100100111111111111000111000000010010010010000001110000001
1000000000000000000000000011100000010010010010000011100000001
1000000111111111111111000000101000010010010000001010000000001
100000011111111111111100000000111L010000010000111000000000001
1000000000000000000000000000000011110000010111100000000000001
1000000001110000011100000000000000011111111100000000000000001
10000001100011011L0011000000000000000011110000000001111111111
1000001100000000000001100000000000000011110000000000000000001
1000011000111111111111110000000000000011110000000000000000001
1000001100000000000001100000000000000011110000000000000000001
1000000111111111100011000000000000000011110000000001111111111
1000000011000000000110000000000000000011110000000000000000001
1000000001100011111100000000000001111111111111100000000000001
1000000000110000011000000000000000000011110000000001111111111
11111100000110001100000000000000000000111100000000000000000L1
1L00000010001101100000000000000000000011110000000100000000001
1000000010000000000000000000000000000000000000001100000000001
1000000L100000N00000000000000000000000000000000011L0000000001
1111111111111111111111111111111111111111111111111111111111111
