NO ./textures/fence/purple.xpm
SO ./textures/fence/blue.xpm
WE ./textures/fence/brown.xpm
EA ./textures/fence/PINK!.xpm

C 255,149,6
F ./textures/grass/grass.xpm

        1111111111111111111111111
        1000000000110000000000001
        1011000001110000000000001
        1001000000000000000000001
111111111011000001110000000000001
100000000011000001110111100011111
11110111111111011100000010001
1111011111111101110101001L001
11000000110101011100000010L01
10000000000000000000000000001
10000000000000001101010010001
11000001110101011111011110W0111
11110111 1110101 101111010001
11111111 1111111 111111111111
