NO ./textures/fence/purple.xpm
SO ./textures/fence/purple.xpm
WE ./textures/fence/purple.xpm
EA ./textures/fence/purple.xpm

C 255,149,6
F ./textures/grass/grass.xpm

        1111111111111111111111111
        1000000000110000000000001
        1011000001110000000000001
        1001000000000000000000001
1111111110110000L1110000000000001
100000000011000001110111100011111
11110111111111011100000010001
11110111111111011101010010001
11000000110101L11100000010001
10000000000000000000000000L01
10000000000000001101010010001
11000001110101011111011110N0111
11110111 1110101 101111010001
11111111 1111111 111111111111
