NO ./textures/redbrick.xpm
SO ./textures/wood.xpm
WE ./textures/metal.xpm
EA ./textures/tile.xpm

C 86,125,70
F 135,206,235

        1111111111111111111111111 11111
        1000000000110000000000001 11111
        1011000001110000000000001 11111
        1001000000000000D00000001
111111111011000001110000000000001
100000000011000001110111100011111
11110111111111011100000011D11
111101111111110111010100100011111
11000000110101011100000010001
100000000000000011000000D0001
10000000000000001101010010001
11000001110101011111011110N0111
11110111 1110101 101111010001
11111111 1111111 111111111111