NO ./textures/wood.xpm
SO ./textures/wood.xpm
WE ./textures/metal.xpm
EA ./textures/wood.xpm

C ./textures/light_wood_floor.xpm
F ./textures/grass1.xpm

        1111111111111111111111111 11111
        1000000000110000000000001 11111
        1011000001110000000000001 11111
        1001000000000000000000001
111111111011000001110000000000001
100000000011000001110111100011111
11110111111111011100000010001
111101111111110111010100100011111
11000000110101011100000010001
10000000000000001100000000001
10000000000000000001010010001
11000001110101011111011110N0111
11110111 1110101 101111010001
11111111 1111111 111111111111