NO textures/fence/blue.xpm
SO textures/fence/blue.xpm
WE textures/fence/blue.xpm
EA textures/fence/blue.xpm


C 255,165,0
F textures/grass/grass.xpm



                11
               1001
              100001
             100L0001
            1000000001
           100000000001
          11111111111001
         1000000000000001
        100111111111000001
       10000000000001110001
      1001111111110000110001
     100000000000011110000001
    10011111111110010000000001
   1001000000000100010000111111
  1S0111100010001000010000000001
 10001000000100000000010000000001
1111111111111111111111111111111111