1111111
1000001
100E001
1000001
1111011