NO ./textures/wood.xpm
SO ./textures/wood.xpm
WE ./textures/metal.xpm
EA ./textures/wood.xpm

C 86,125,70
F 135,206,235

111111111111111111
100000000000000001
100000000000000001
100000000000000001
100000000000000001
100000000000000001
10N000000000000001
111111111111111111111111